00M0000000
0000000000
000000L000
00T0000M00
0000000000
1000000002
0000000000
00M0000000
000000T000
00T00000L0
0000L00000